1111111111111111111111111111111111111111111111111111111111111
100010100000001010100010C010101010101010001000100000000000001
1000100000100010000000100010000000001010001000101010001010101
1000100010100010101010000010001010000000001010101000001000001
1000100010000000001000101010101000101010001010001010001010101
1000100010001010P01000100000001000100010000000001000C00000001
1000100000000010001000000010001000100000001010101010001010101
1000101010100010101010101010001010100010101000000000000000101
1000000000000010000000000010000000100000001000100010100010001
1010101010100010101000101010101000100010101000100000001010101
1000000000100000001000100000001000100010000000100010100000001
1000101000100010101000101010001000100010001010100010001010101
1000101000000000001000000010001C00000010001000000010000000001
1000101000101010001010100010001010100010001010101010101010101
10000C1000100010000000000010000000000000000000000000000000001
1000101010100010001010101010001000101010001000101010001000101
1000000000000010001000000000C01000100010000000000010000000101
101010101000101010101010101000100010001010100010101C001010101
1000100000100010000000100010000000001010001000101010001010101
1010101C10001010101010101010001000100010101000101010001010101
1000100000000010001000000010001000100000001010101010001000101
1010101010001010101010101010001000100010101000101010001010101
1000100000000010001000000010001000100000001010101010001010101
1010101010001010101010101010001000100010101000101010001010101
1000100010000000001000101010101000101010001010001010001010101
1000100000100010000000100010000000001010001000101010001010101
1000000000100000001000100000001000101110000000100010100000001
1000100010001010001000100000001000101010000000001000C00000001
1000101000101010001010100010001010101110001010101010101010101
10000010001C00100000000000100000000010000000100000000000E0001
1000100010001010101000100000001000100010000000001000C00000001
1010101010001010101010101010001000000010101000101010001010101
1001100000000010001000000010001000100000000010101010001010101
1000000010000000000000100000000000100000001000000000000000001
1111111111111111111111111111111111111111111111111111111111111
