111111111111111111111111111111111111111111111111111111111111
1C001010000X001010100010C01010101010101000100010000000000001
10001000001000100000001000100000000X101000100010101001010001
100010001010001010101000001000101000000000101010100C00000001
1000100010000X0000100010101010100X10101000101000101001010001
100010X010001010P010001000000010001000100000000010000000X001
100010000000001000100000001000100010000000101010101001010001
100010101010001010101010101000101010001010100000000000010001
1000000000000010000000000010000000100X0000100010001001000001
101010101010001010100010101010100010001010100010000001010001
100000000010000000100010000000100010001000000010001000000001
100010100010001010100X10101000100010001000101010X01001010001
1000101000000000001000000010001C00000X1000100000001000000001
100010100010101000101010001000101010001000101010101001010001
10000C100010001000X0000000100X000X0000000X000000000000000001
10001010101000100010101010C000100010101000100010101000010001
10001010101000101010101010100010101000101010000000000001C001
100000000000001000000000001000000010000000100010001001000001
1010101X1010001010100010101010100010001010100010000001X10001
10001010101000101010101X10100010101000101010000X000000010001
10000000001000000010001000000X10001000100000C010001000000001
1000100010000000001000101010101000101010001010001X1001010001
10001000100X10100010001000C000100010001000000000100000000001
10000C1000100010000000000010000000000X0000000X00000000E0X001
10001000000000100010000000100010001000X000101010101001010001
100010101010X01010101010101000101010001010100000000000010001
10101010101000101010001010101010001000101010001X000001010001
100010001010001010101000001X00101X00000000101010100000000001
100010001000000000100X10101010100010101000101000101001010001
111111111111111111111111111111111111111111111111111111111111
