111111111111111111111111111111111111111111111111111111111111
1C0010100000001010100010C01010101010101000100010000000000001
100010000010001000000010001000000000101000100010101001010001
100010001010001010101000001000101000000000101010100C00000001
100010001000000000100010101010100010101000101000101001010001
1000100010001010P0100010000000100010001000000000100000000001
100010000000001000100000001000100010000000101010101001010001
100010101010001010101010101000101010001010100000000000010001
100000000000001000000000001000000010000000100010001001000001
101010101010001010100010101010100010001010100010000001010001
100000000010000000100010000000100010001000000010001000000001
100010100010001010100010101000100010001000101010001001010001
1000101000000000001000000010001C0000001000100000001000000001
100010100010101000101010001000101010001000101010101001010001
10000C100010001000000000001000000000000000000000000000000001
10001010101000100010101010C000100010101000100010101000010001
10001010101000101010101010100010101000101010000000000001C001
100000000000001000000000001000000010000000100010001001000001
101010101010001010100010101010100010001010100010000001010001
100010101010001010101010101000101010001010100000000000010001
10000000001000000010001000000010001000100000C010001000000001
100010001000000000100010101010100010101000101000101001010001
10001000100010100010001000C000100010001000000000100000000001
10000C100010001000000000001000000000000000000000000000E00001
100010000000001000100000001000100010000000101010101001010001
100010101010001010101010101000101010001010100000000000010001
101010101010001010100010101010100010001010100010000001010001
100010001010001010101000001000101000000000101010100000000001
100010001000000000100010101010100010101000101000101001010001
111111111111111111111111111111111111111111111111111111111111
