1111111111111111111
1X1C00000000000C1X1
1100100000000010011
10000100XCX00100001
1000001000001000001
1000000100010000001
1000000010100000001
100XCX000P000XCX001
1000000010100000001
1000000100010000001
1000001000001000001
1000010000000100001
10001000XCX00010001
1101000X000X0001011
1X1C00X00E00X00C1X1
1111111111111111111
