1111111111111111111
1P00000000000000001
1000000C00000000001
1000000000000000001
1000000000000000001
1000000110000000001
1000000110000000001
1000000000000000001
1000000000000000001
1000000000000000001
100000000C000000001
1000000000000000001
1000000000000000001
1C000000000000000E1
1111111111111111111
